00000000000
00011111100
00010000111
11110000000
00000000000